15,21,20,15,14,09,09,17,10,10
09,16,14,07,00,00,02,16,15,21
09,07,00,00,00,00,00,00,02,16
12,08,00,18,11,12,06,05,04,18
13,08,00,17,10,19,12,09,18,22
19,12,00,16,15,15,14,09,16,15
10,13,05,05,05,05,05,05,05,05
10,13,01,01,01,01,01,01,01,09
10,19,11,11,11,11,11,11,11,11
10,10,10,10,10,10,10,10,10,10

0,0,0,0,0,0,0,0,0,0,0,1,1,1,1,1,1,1,1,1,1,1,0,0,0
0,0,0,0,0,0,0,0,0,0,1,0,0,0,0,0,0,0,0,0,0,0,1,0,0
0,0,0,0,0,0,0,0,0,0,1,0,0,0,0,0,0,0,0,0,0,0,0,1,0
0,0,0,0,0,0,0,0,0,0,1,0,0,0,0,0,0,0,1,0,0,0,0,0,1
